[
    [
        "11000001000000000011",
        "11000001000000000011",
        "11000001000000000011",
        "1000000C000000000001",
        "1000000C000000000001",
        "1000000C000000000001",
        "11111111100111111111",
        "11111111100111111111",
        "11111111100111111111",
        "11111111100111111111",
        "11111111100111111111",
        "11111111100111111111",
        "11111111100111111111",
        "111000S0000000000111",
        "11100000000000000111",
        "11190000000000000111",
        "11111111111111111111",
        "11111111111111111111",
        "11111111111111111111",
        "11111111111111111111",
        "11111111111111111111",
        "11111111111111111111"
    ],
    [
        "11000001000000000111",
        "11000001000000000111",
        "11000001000000000111",
        "1000000C000000000011",
        "1000000C000000000011",
        "1000000C000000000011",
        "11111111100111111111",
        "11111111100111111111",
        "11111111100111111111",
        "11111111100111111111",
        "11111111100111111111",
        "11111111100111111111",
        "11111111100111111111",
        "100000C0S00000000111",
        "100000C0000000000111",
        "100000C0000000000111",
        "11110011111110011111",
        "11110011111110011111",
        "11110011111110011111",
        "11110011111110011111",
        "11110011111110011111",
        "11110011111110011111",
        "11000001111000000011",
        "11000001111000000011",
        "11000001111000000011",
        "11111100S00111111111",
        "11111100000111111111",
        "11111100000111111111",
        "11100000000000000111",
        "11100000000000000111",
        "11100000000000009111",
        "11111111111111111111",
        "11111111111111111111",
        "11111111111111111111",
        "11111111111111111111"
    ],
    [
        "11111111111111111111",
        "1P0000C0000000000011",
        "100000C0000000000011",
        "100000C0000000000011",
        "11111111222211111111",
        "11000000000000000011",
        "11000000000000000011",
        "11000000000000000011",
        "11111111222211111111",
        "10000000000000000001",
        "10000000000000000001",
        "10000000000000000001",
        "11111100000011111111",
        "11111100000011111111",
        "11111100000011111111",
        "1000000C000000000001",
        "1000000C000000000001",
        "1000000C000000000001",
        "11111111110011111111",
        "11100000000000000111",
        "11100000000000000111",
        "11100000000000000111",
        "11111222222222111111",
        "10000000000000000001",
        "10000000000000000001",
        "10000000000000000001",
        "11111111100111111111",
        "11100000000000000111",
        "11190000000000000111",
        "11111111111111111111"
    ],
    [
        "11111111111111111111",
        "11P00001000000000011",
        "11000001000000000011",
        "11000001000000000011",
        "1000000C000000000001",
        "1000000C000000000001",
        "1000000C000000000001",
        "11111111110011111111",
        "11111111110011111111",
        "11111111110011111111",
        "10000000000000000001",
        "10000000000000000001",
        "10000000000000000001",
        "11111222200111111111",
        "11111111100111111111",
        "11111111S00111111111",
        "11111111100111111111",
        "11100000000000000111",
        "11100000000000000111",
        "11100000000000000111",
        "11111111222111111111",
        "100000C0000000000001",
        "100000C0000000000001",
        "100000C0000000000001",
        "11111111111000111111",
        "11111111111000111111",
        "11111111111000111111",
        "10000000000000000001",
        "10000000000000000001",
        "10000000000000000001",
        "11110011111111111111",
        "11190011111111111111",
        "11111111111111111111"
    ],
    [
        "11111111111111111111",
        "11000001000000000011",
        "11P00001000000000011",
        "11000001000000000011",
        "1000000C000000000001",
        "1000000C000000000001",
        "1000000C000000000001",
        "11111111100111111111",
        "11111111100111111111",
        "11111111100111111111",
        "100000C0000000000001",
        "100000C0000000000001",
        "100000C0000000000001",
        "11111111222211111111",
        "11111111222211111111",
        "11111111222211111111",
        "1V000000000000000001",
        "10000000000000000001",
        "10000000000000000001",
        "11111110011111111111",
        "11111110011111111111",
        "11111110011111111111",
        "10000000000C00000001",
        "10000000000C00000001",
        "10000000000C00000001",
        "11111111111111100111",
        "11111111111111100111",
        "11111111111111100111",
        "1000000C000000000001",
        "1000000C000000000001",
        "1000000C000000000001",
        "11111111111222111111",
        "11100000000000000111",
        "11100000000000000111",
        "11190000000000000111",
        "11111111111111111111"
    ],
    [
        "11111111111111111111",
        "11P00001112200000011",
        "11000001112200000011",
        "11000001112200000011",
        "1000000C000000000001",
        "1000000C000000000001",
        "1000000C000000000001",
        "11111111000111111111",
        "11111111S00111111111",
        "11111111000111111111",
        "10000000000000000001",
        "10000000000000000001",
        "10000000000000000001",
        "11111110011111111111",
        "11111110011111111111",
        "11111110011111111111",
        "100000C0000000000001",
        "100000C0000000000001",
        "100000C0000000000001",
        "11111111222211111111",
        "11111111222211111111",
        "11111111222211111111",
        "10000000000000000001",
        "10000000000000000001",
        "10000000000000000001",
        "11111100111111111111",
        "11111100S11111111111",
        "11111100111111111111",
        "1000000C000000000001",
        "1000000C000000000001",
        "1000000C000000000001",
        "11111111111100111111",
        "11111111111100111111",
        "11111111111100111111",
        "10000000000000000001",
        "10000000000000000001",
        "10000000000000000001",
        "11110011111111111111",
        "11190011111111111111",
        "11111111111111111111"
    ],
    [
        "11111111111111111111",
        "11000001000000000011",
        "11P00001000000000011",
        "11000001000000000011",
        "1000000C000000000001",
        "1000000C000000000001",
        "1000000C000000000001",
        "11111111100111111111",
        "11111111100111111111",
        "11111111100111111111",
        "1V00000C000000000001",
        "1000000C000000000001",
        "1000000C000000000001",
        "11111111110011111111",
        "11111111110011111111",
        "11111111110011111111",
        "10000000000000000001",
        "10000000000000000001",
        "10000000000000000001",
        "11111222222211111111",
        "11111222222211111111",
        "11111222222211111111",
        "10000000000000000001",
        "10000000000000000001",
        "10000000000000000001",
        "11111100111111111111",
        "11111100S11111111111",
        "11111100111111111111",
        "100000C0000000000001",
        "100000C0000000000001",
        "100000C0000000000001",
        "11111111222111111111",
        "11111111222111111111",
        "11111111222111111111",
        "10000000000000000V01",
        "10000000000000000001",
        "10000000000000000001",
        "11111110011111111111",
        "11111110011111111111",
        "11111110011111111111",
        "11100000000000000111",
        "11190000000000000111",
        "11111111111111111111"
    ],
    [
        "11111111111111111111",
        "11P00001000000000011",
        "11000001000000000011",
        "11000001000000000011",
        "1000000C000000000001",
        "1000000C000000000001",
        "1000000C000000000001",
        "11111111222211111111",
        "11111111222211111111",
        "11111111222211111111",
        "1V000000000000000001",
        "10000000000000000001",
        "10000000000000000001",
        "11111111000111111111",
        "11111111S00111111111",
        "11111111000111111111",
        "100000C0000000000001",
        "100000C0000000000001",
        "100000C0000000000001",
        "11111111111100111111",
        "11111111111100111111",
        "11111111111100111111",
        "10000000000000000001",
        "10000000000000000001",
        "10000000000000000001",
        "11110011111111111111",
        "11110011111111111111",
        "11110011111111111111",
        "1000000C000000000001",
        "1000000C000000000001",
        "1000000C000000000001",
        "11111111222222111111",
        "11111111222222111111",
        "11111111222222111111",
        "10000000000000000V01",
        "10000000000000000001",
        "10000000000000000001",
        "11111100111111111111",
        "11111100S11111111111",
        "11111100111111111111",
        "1000000C000000000001",
        "1000000C000000000001",
        "1000000C000000000001",
        "11111111111111100111",
        "11190000000000000111",
        "11111111111111111111"
    ],
    [
        "11111111111111111111",
        "11000001000000000011",
        "11P00001000000000011",
        "11000001000000000011",
        "1000000C000000000001",
        "1000000C000000000001",
        "1000000C000000000001",
        "11111111110011111111",
        "11111111110011111111",
        "11111111110011111111",
        "1V00000C000000000001",
        "1000000C000000000001",
        "1000000C000000000001",
        "11111111111222111111",
        "11111111111222111111",
        "11111111111222111111",
        "10000000000000000001",
        "10000000000000000001",
        "10000000000000000001",
        "11111100111111111111",
        "11111100S11111111111",
        "11111100111111111111",
        "100000C0000000000001",
        "100000C0000000000001",
        "100000C0000000000001",
        "11111111000111111111",
        "11111111000111111111",
        "11111111000111111111",
        "10000000000000000V01",
        "10000000000000000001",
        "10000000000000000001",
        "11111222222211111111",
        "11111222222211111111",
        "11111222222211111111",
        "1000000C000000000001",
        "1000000C000000000001",
        "1000000C000000000001",
        "11111111110011111111",
        "11111111S10011111111",
        "11111111110011111111",
        "10000000000000000001",
        "10000000000000000001",
        "10000000000000000001",
        "11111111222111111111",
        "11111111222111111111",
        "11111111222111111111",
        "11100000000000000111",
        "11190000000000000111",
        "11111111111111111111"
    ],
    [
        "11P00001000000000111",
        "11000001000000000111",
        "11000001000000000111",
        "11111100C00111111111",
        "100000C0000000000111",
        "100000C0000000000111",
        "100000C0000000000111",
        "11110011111110011111",
        "11110011111110011111",
        "11110011111110011111",
        "100000C0000C00000011",
        "100000C0000C00000011",
        "100000C0000C00000011",
        "11111111222111111111",
        "10000000000000000001",
        "10000000000000000001",
        "10000000000000000001",
        "11110011111111100111",
        "11110011111111100111",
        "11110011111111100111",
        "100000C0000000000001",
        "100000C0000000000001",
        "100000C0000000000001",
        "11111113333333311111",
        "10000000000000000001",
        "10000000V00000000001",
        "10000000000000000001",
        "11111100000000011111",
        "11111100000000011111",
        "11111100000000011111",
        "1000000C00C0000C0001",
        "1000000C00C0000C0001",
        "1000000C00C0000C0001",
        "11111111001111111111",
        "10000000000000000001",
        "10000000000000000001",
        "10000000000000000001",
        "11100000000000000111",
        "11100000000000000111",
        "11190000000000000111",
        "11111111111111111111",
        "11111111111111111111",
        "11111111111111111111"
    ]
]