[
    [
        "11000001000000000111",
        "11000001000000000111",
        "11000001000000000111",
        "1000000C000000000011",
        "1000000C000000000011",
        "1000000C000000000011",
        "11111111100111111111",
        "11111111100111111111",
        "11111111100111111111",
        "11111111100111111111",
        "11111111100111111111",
        "11111111100111111111",
        "11111111100111111111",
        "111000S0000000000111",
        "11100000000000000111",
        "11190000000000000111",
        "11111111111111111111",
        "11111111111111111111",
        "11111111111111111111",
        "11111111111111111111",
        "11111111111111111111",
        "11111111111111111111"
    ],
    [
        "11000001000000000111",
        "11000001000000000111",
        "11000001000000000111",
        "1000000C000000000011",
        "1000000C000000000011",
        "1000000C000000000011",
        "11111111100111111111",
        "11111111100111111111",
        "11111111100111111111",
        "11111111100111111111",
        "11111111100111111111",
        "11111111100111111111",
        "11111111100111111111",
        "100000C0S00000000111",
        "100000C0000000000111",
        "100000C0000000000111",
        "11110011111110011111",
        "11110011111110011111",
        "11110011111110011111",
        "11110011111110011111",
        "11110011111110011111",
        "11110011111110011111",
        "11000001112200000011",
        "11000001112200000011",
        "11000001112200000011",
        "11111100S00111111111",
        "11111100000111111111",
        "11111100000111111111",
        "11100000000000000111",
        "11100000000000000111",
        "11100000000000009111",
        "11111111111111111111",
        "11111111111111111111",
        "11111111111111111111",
        "11111111111111111111"
    ],
    [
        "11111111111111111111",
        "100000C0000100000001",
        "1P0000C0008100000001",
        "100000C0000100000001",
        "11111111001111110001",
        "1111111300S000000001",
        "11111113000000000001",
        "11111113000000000001",
        "1111111111222111V001",
        "100000000S0000000001",
        "10000000000000000001",
        "10000000000000000001",
        "12221111111111111111",
        "10000000000000000001",
        "10000000000000000001",
        "10000000000000000001",
        "11111133333333122221",
        "10000000000000000001",
        "10000008000080000001",
        "10000000000000000001",
        "11111111100111111111",
        "100000000000C000S001",
        "100000000000C0000001",
        "100000000000C0000001",
        "11000111111113332221",
        "10000000001000000001",
        "10000000001080000001",
        "10000000001000000001",
        "111111100V1111000111",
        "10000000001000000001",
        "10000000001000000001",
        "10000000001000000001",
        "10001111111222111111",
        "1000C000010000C00001",
        "1000C000010800C00001",
        "1000C000010000C00001",
        "11111111112221111111",
        "100C0S0C0S0C0S0C0S01",
        "180C000C000C000C0001",
        "100C000C000C000C0001",
        "12222222222222222221",
        "10010001000C00010001",
        "V0010001000C00010001",
        "10010001000C00010001",
        "10010001001110010001",
        "1001000C00S1S0010001",
        "1001000C00010001V001",
        "1001000C000100010001",
        "10011111111100010001",
        "100CS00S000S00010001",
        "100C0000000000010001",
        "100C0000000000010001",
        "100V1111000100010001",
        "10011111000100010001",
        "10011111000100010001",
        "10011111000000000001",
        "V0013333333333333331",
        "10000000000011111111",
        "10000000000011111111",
        "10000000000011111111",
        "10000111122211111111",
        "10000111100000000S01",
        "100001111V0000000001",
        "10000111100000000001",
        "10000111112222222211",
        "10000000000000000001",
        "10000000000000000001",
        "10000000000000000001",
        "13333311V00311111111",
        "11111111000311111111",
        "11111111000311111111",
        "11111111000111111111",
        "11111111000111111111",
        "11111111000111111111",
        "11111111000111111111",
        "11111111000111111111",
        "11111111000111111111",
        "1111111100V111111111",
        "11111111000111111111",
        "11111111000111111111",
        "11111111000111111111",
        "11111111000111111111",
        "11111111000111111111",
        "11111111000111111111",
        "11111111000111111111",
        "11111111V00111111111",
        "11111111000111111111",
        "11111111000111111111",
        "11111111000111111111",
        "11111111000111111111",
        "11111111000111111111",
        "11111111000111111111",
        "11111111000111111111",
        "11111113000111111111",
        "1111111300V111111111",
        "11111113000111111111",
        "11111113000111111111",
        "10000000000000000001",
        "10000000000000008001",
        "10000000000000000001",
        "13333333331111111221",
        "100000000000S0000001",
        "100000800000000000V1",
        "19000000000000000001",
        "11111111111111111111",
        "11111111111111111111",
        "11111111111111111111",
        "11111111111111111111",
        "11111111111111111111",
        "11111111111111111111"
    ],
    [
        "11111111111111111111",
        "10000000000000000001",
        "10000000000000000001",
        "10111111122111111101",
        "101V0000000000080101",
        "101V0000000000080101",
        "101V0000000000080101",
        "101V0000000000080101",
        "101V0000000000080101",
        "101V0000000000080101",
        "10110000000000081101",
        "10111900000000111001",
        "10001113333331100001",
        "10000000000000000001",
        "11111111111111111111"
    ],
    [
        "11111111111111111111",
        "10000000000000000001",
        "10000000000000000001",
        "10000000000000000001",
        "10000000000000000001",
        "10000000000000000001",
        "10000000000000000001",
        "10000000000000000001",
        "10000000000000000001",
        "10000000000000000001",
        "10000000000000000001",
        "10000000000000000001",
        "10000000000000000001",
        "10000000000000000001",
        "11111111111111111111"
    ],
    [
        "11111111111111111111",
        "10000000000000000001",
        "10000000000000000001",
        "10000000000000000001",
        "10000000000000000001",
        "10000000000000000001",
        "10000000000000000001",
        "10000000000000000001",
        "10000000000000000001",
        "10000000000000000001",
        "10000000000000000001",
        "10000000000000000001",
        "10000000000000000001",
        "10000000000000000001",
        "11111111111111111111"
    ],
    [
        "11111111111111111111",
        "10000000000000000001",
        "10000000000000000001",
        "10000000000000000001",
        "10000000000000000001",
        "10000000000000000001",
        "10000000000000000001",
        "10000000000000000001",
        "10000000000000000001",
        "10000000000000000001",
        "10000000000000000001",
        "10000000000000000001",
        "10000000000000000001",
        "10000000000000000001",
        "11111111111111111111"
    ],
    [
        "11111111111111111111",
        "10000000000000000001",
        "10000000000000000001",
        "10000000000000000001",
        "10000000000000000001",
        "10000000000000000001",
        "10000000000000000001",
        "10000000000000000001",
        "10000000000000000001",
        "10000000000000000001",
        "10000000000000000001",
        "10000000000000000001",
        "10000000000000000001",
        "10000000000000000001",
        "11111111111111111111"
    ],
    [
        "11111111111111111111",
        "10000000000000000001",
        "10000000000000000001",
        "10000000000000000001",
        "10000000000000000001",
        "10000000000000000001",
        "10000000000000000001",
        "10000000000000000001",
        "10000000000000000001",
        "10000000000000000001",
        "10000000000000000001",
        "10000000000000000001",
        "10000000000000000001",
        "10000000000000000001",
        "11111111111111111111"
    ],
    [
        "11111111111111111111",
        "10000000000000000001",
        "10000000000000000001",
        "10000000000000000001",
        "10000000000000000001",
        "10000000000000000001",
        "10000000000000000001",
        "10000000000000000001",
        "10000000000000000001",
        "10000000000000000001",
        "10000000000000000001",
        "10000000000000000001",
        "10000000000000000001",
        "10000000000000000001",
        "11111111111111111111"
    ]
]